NO 
SO ./path_to_the_south_texture
WE ./path_to_the_west_texture
EA ./path_to_the_east_texture
F 220,100,255
C    225,30,0

11111111
100010  1
1001N101
10001111
1000   1
11111111