NO ./path_to_the_north_texture
SO ./path_to_the_south_texture
WE ./path_to_the_west_texture
EA ./path_to_the_east_texture
F 220,100,8
C 225,30,0


 111111111000
111001001 1
100N111 01
110000111 
1111111
   1